WWWWWWWWWWWWWWW
WP-----W-W---WW
W-WWWW-W-W-W-WW
W-W-WW-W-W-W--W
W-W-WW---W-WW-W
W-W-WWWWWW-WW-W
W-------WW-WW-W
W-WWWW--WW--WWW
W-WWW--WWW-WWWW
W-WWW-WWWW-WWWW
WWWWW--------GW
WWWWWWWWWWWWWWW