WWWWWWWWWWWWWWW
W-H----G-H----W
W---H--H--H---W
W--H---H------W
W-H--H-----H--W
W--H--H--H----W
W------H------W
W--H----H--H--W
W----H---H----W
W---H-H----H--W
W--H--P---HH--W
WWWWWWWWWWWWWWW