WWWWWWWWWWWWWWW
W--H----H----GW
WH---H----H---W
W--H--H----H--W
W--H---H---H--W
W----H---H----W
W-H---H----H--W
W---H---H-H---W
W-H----H------W
W----H-----H--W
W-P-----H---H-W
WWWWWWWWWWWWWWW