WWWWWWWWWWWWWWW
WP--H--H---HH-W
W-H-H-----H---W
W--H----H-----W
W--H---H----H-W
W-----H---H---W
W--H----H--H--W
W-H-----------W
W---H---H--HH-W
W-------H-----W
W--H--H---H--GW
WWWWWWWWWWWWWWW